1111111111111111
1000000000000001
1001000000000N01
1001000000000001
1001000000000001
1111111111111111