NO bonus/textures/north.png
SO bonus/textures/south.png
WE bonus/textures/west.png
EA bonus/textures/east.png

C 250,235,215
F 210,180,140

1111111111111111111
1000000000000000001
1000010001000100001
1001000100010001001
1000010000000100001
100000000N000000001
1111111111111111111
