NO bonus/textures/north.png
SO bonus/textures/south.png
WE bonus/textures/west.png
EA bonus/textures/east.png

C 250,235,215
F 210,180,140

111111111111111111111111111111
111111111011000001110000000001
100000000011000001110111111111
111101111111110111000000100001
111101111111110111010100100001
110001001101010111N00000000001
100011000000001100000010001101
100001000000000011010100100001
110000011101010111110111110011
111111111111111111111111111111