NO mandatory/textures/north.png
SO mandatory/textures/south.png
WE mandatory/textures/west.png
EA mandatory/textures/east.png

C 150,142,132
F 140,140,130

1111111111111111
1000010000000001
1000000010000001
1000000000000001
1000000000000001
10000000N0000001
1000000000000001
1111111111111111