NO mandatory/textures/north.png
SO mandatory/textures/south.png
WE mandatory/textures/west.png
EA mandatory/textures/east.png

F 185,148,112
C 137,207,243 

1111111111111111
1000000000000001
1001000010000001
10010001S0000001
1001000000000001
1001000000000001
1001000000000001
1111111111111111