NO mandatory/textures/north.png
SO mandatory/textures/south.png
WE mandatory/textures/west.png
EA mandatory/textures/east.png

F 185,148,112
C 137,207,243 

        1111111111111111111111111
        1000010000110000000000001
        10101E1001110000000000001
        1001010000000000000000001
111111111011000001110000000000001
100000000011000001110111111111111
11110111111111011100000010001
11110111111111011101010010001
11000100110101011100000000001
1000110000000011000000100011
10000100000000001101010010001
1100000111010101111101111100111
11110111 1110101 101111010001
11111111 1111111 111111111111